1111111111
1000000001
1110111101
1000100001
1011111011
1000000001
1111111111