1111111111
1000001001
1011101111
1000100001
1111111101
1000000001
1111111111