1111111111
1000100001
1010101111
1010000001
1110111101
1000000001
1111111111