111111111
100000001
101111101
100100001
111101111
100000001
111111111