111111111
100000001
101111101
100100101
111101101
100000001
111111111