111111111
100010001
101110101
100000001
101111101
100000001
111111111