111111111
100000001
101111101
101000101
101110101
100000001
111111111